TILEMAP
16 16 			-- Size of tile map in tiles
32 32			-- Tile size & block size
images/ice-blocks2.png 	-- Tilesheet
4 4			-- Number of tiles in tilesheet
6:;0005:::::::66
700000?000000056
;000008p00000056
0000000000000056
0000x000x0000056
0000000000000056
000000000000009:
0000000000000000
0000000000000000
0000000000000000
0000000000000000
0000000000000000
00s000ooo0000000
oo4ooo123000rr00
222223567ooo44oo
6666675671222222